15,8,,,,,,,,,,,,,
1,1,0,0,0,0,0,1,0,0,0,0,0,0,0
1,1,0,0,0,0,0,0,0,1,0,1,1,0,0
0,0,0,0,0,0,0,0,0,0,1,0,0,0,1
0,0,0,P2,0,P3,P1,P5,0,0,0,0,0,0,0
0,0,0,0,0,0,0,0,0,0,0,0,0,0,0
1,0,0,0,0,P4,0,P6,0,0,0,0,0,0,0
0,0,1,1,0,0,0,0,0,0,0,0,0,1,1
0,1,0,0,0,1,0,1,0,0,0,0,0,1,1
