15,8,,,,,,,,,,,,,
1,1,0,0,0,0,0,1,0,0,0,0,0,0,0
1,1,0,P3,0,0,0,0,0,1,0,1,1,0,0
0,0,P1,0,0,0,0,0,0,0,1,0,0,0,1
0,P2,0,0,0,0,0,0,0,0,0,0,0,0,0
0,0,0,0,0,0,0,0,0,0,0,0,0,P5,0
1,0,0,0,0,0,0,0,0,0,0,0,P4,0,0
0,0,1,1,0,0,0,0,0,0,0,P6,0,1,1
0,1,0,0,0,1,0,1,0,0,0,0,0,1,1
